{
  "name": "Test Map",
  "width": 20,
  "height": 20,
  "tileset": "dungeon",
  "layout": [ 
    ["#", "#", "#", "#", "#", "#", "#", "#", "#", "#", "#", "#", "#", "#", "#", "#", "#", "#", "#", "#"],
    ["#", "@", " ", "a", " ", " ", " ", " ", " ", " ", " ", " ", " ", " ", " ", " ", " ", " ", " ", "#"],
    ["#", " ", " ", " ", " ", " ", "#", " ", "#", "#", "#", "#", "#", " ", "#", "#", "#", "#", " ", "#"],
    ["#", " ", " ", " ", " ", " ", " ", " ", " ", " ", " ", " ", "#", " ", " ", " ", " ", "#", " ", "#"],
    ["#", "a", " ", " ", "#", "#", "#", "#", " ", " ", "#", " ", "#", "#", " ", " ", " ", "#", " ", "#"],
    ["#", " ", "#", " ", " ", " ", " ", " ", " ", " ", "#", " ", " ", " ", " ", " ", " ", " ", " ", "#"],
    ["#", " ", "#", "#", "#", " ", " ", "#", "#", " ", "#", " ", "#", "#", " ", " ", "#", "#", " ", "#"],
    ["#", " ", " ", " ", " ", " ", " ", " ", "#", " ", "#", " ", " ", " ", " ", " ", " ", " ", " ", "#"],
    ["#", "#", "#", " ", " ", " ", "#", " ", "#", " ", " ", " ", " ", " ", "#", "#", "#", "#", "#", "#"],
    ["#", " ", " ", " ", " ", " ", " ", " ", "#", " ", " ", " ", " ", " ", " ", " ", " ", " ", " ", "#"],
    ["#", " ", "#", "#", "#", " ", " ", " ", "#", " ", " ", " ", "#", "#", "#", "#", "#", "#", " ", "#"],
    ["#", " ", " ", " ", " ", " ", " ", " ", " ", " ", "#", " ", " ", " ", " ", " ", " ", " ", " ", "#"],
    ["#", " ", "#", "#", "#", "#", "#", " ", "#", "#", "#", "#", "#", "#", " ", " ", "#", "#", " ", "#"],
    ["#", " ", " ", " ", " ", " ", " ", " ", " ", " ", " ", " ", " ", " ", " ", " ", " ", " ", " ", "#"],
    ["#", " ", "#", " ", "#", "#", " ", " ", " ", "#", " ", " ", " ", "#", "#", "#", "#", "#", "#", "#"],
    ["#", " ", "#", " ", " ", " ", " ", " ", " ", " ", " ", " ", " ", " ", " ", " ", " ", " ", " ", "#"],
    ["#", " ", "#", "#", "#", "#", "#", "#", "#", "#", "#", " ", " ", "#", "#", " ", "#", "#", " ", "#"],
    ["#", " ", " ", " ", " ", " ", " ", " ", " ", " ", " ", " ", " ", " ", " ", " ", " ", " ", " ", "#"],
    ["#", " ", " ", " ", " ", "#", "#", " ", "#", "#", " ", " ", " ", "#", "#", "#", "#", " ", "#", "#"],
    ["#", "#", "#", "#", "#", "#", "#", "#", "#", "#", "#", "#", "#", "#", "#", "#", "#", "#", "#", "#"]
  ]
}
