{
  "name": "Test Map",
  "width": 20,
  "height": 20,
  "tileset": "tech",
  "playerStartDir": 1,
  "layout": [ 
    "####################",
    "# @| c          |  #",
    "#w # w# ###-# #### #",
    "#  :t #t  | :t c #c#",
    "#t #b ## c# ##   # #",
    "##-#  t h # c#c   w#",
    "## #tw          h  #",
    "#b w  b #c h  wc  b#",
    "##:## #-#     ###_##",
    "#  #c   #b  c      #",
    "#b ## wc# w #:#### #",
    "#        c#     | t#",
    "#-#####:#:#-##  ## #",
    "#                  #",
    "#c# ##c  #  h###:###",
    "# # |   b t  |     #",
    "# #####:###  ## ## #",
    "#        |  c   |  #",
    "#ctc ## ## cc#### ##",
    "####################"
  ]
}
