{
  "name": "Test Map",
  "width": 20,
  "height": 20,
  "tileset": "dungeon",
  "playerStartCell": [2, 3],
  "playerStartDir": 0,
  "layout": [ 
    ["#", "#", "#", "#", "#", "#", "#", "#", "#", "#", "#", "#", "#", "#", "#", "#", "#", "#", "#", "#"],
    ["#", " ", " ", "#", " ", " ", " ", " ", " ", " ", " ", " ", " ", " ", " ", " ", " ", " ", " ", "#"],
    ["#", " ", " ", "|", " ", " ", "#", " ", "#", "#", "#", "#", "#", " ", "#", "#", "#", "#", " ", "#"],
    ["#", "o", " ", "#", " ", " ", "a", " ", " ", " ", " ", " ", "#", " ", " ", " ", " ", "#", " ", "#"],
    ["#", " ", "s", " ", " ", "#", "#", "#", " ", " ", "#", " ", "#", "#", " ", " ", " ", "#", " ", "#"],
    ["#", "a", "#", " ", " ", " ", " ", " ", " ", " ", "#", " ", " ", " ", " ", " ", " ", " ", " ", "#"],
    ["#", " ", "#", "#", "#", " ", " ", "#", "#", " ", "#", " ", "#", "#", " ", " ", "#", "#", " ", "#"],
    ["#", " ", " ", " ", " ", " ", " ", " ", "#", " ", "#", " ", " ", " ", " ", " ", " ", " ", " ", "#"],
    ["#", " ", "#", " ", " ", " ", "#", " ", "#", " ", " ", " ", " ", " ", "#", "#", "#", "#", "#", "#"],
    ["#", " ", " ", " ", " ", " ", " ", " ", "#", " ", " ", " ", " ", " ", " ", " ", " ", " ", " ", "#"],
    ["#", " ", "#", "#", "#", " ", " ", " ", "#", " ", " ", " ", "#", "#", "#", "#", "#", "#", " ", "#"],
    ["#", " ", " ", " ", " ", " ", " ", " ", " ", " ", "#", " ", " ", " ", " ", " ", " ", " ", " ", "#"],
    ["#", "#", "#", " ", "#", "#", "#", " ", "#", "#", "#", "#", "#", "#", " ", " ", "#", "#", " ", "#"],
    ["#", " ", " ", " ", " ", " ", " ", " ", " ", " ", " ", " ", " ", " ", " ", " ", " ", " ", " ", "#"],
    ["#", " ", "#", " ", "#", "#", " ", " ", " ", "#", " ", " ", " ", "#", "#", "#", "#", "#", "#", "#"],
    ["#", " ", "#", " ", " ", " ", " ", " ", " ", " ", " ", " ", " ", " ", " ", " ", " ", " ", " ", "#"],
    ["#", " ", "#", "#", "#", "#", "#", "#", "#", "#", "#", " ", " ", "#", "#", " ", "#", "#", " ", "#"],
    ["#", " ", " ", " ", " ", " ", " ", " ", " ", " ", " ", " ", " ", " ", " ", " ", " ", " ", " ", "#"],
    ["#", " ", " ", " ", " ", "#", "#", " ", "#", "#", " ", " ", " ", "#", "#", "#", "#", " ", "#", "#"],
    ["#", "#", "#", "#", "#", "#", "#", "#", "#", "#", "#", "#", "#", "#", "#", "#", "#", "#", "#", "#"]
  ]
}
