{
  "name": "Test Map",
  "width": 20,
  "height": 20,
  "tileset": "tech",
  "playerStartCell": [2, 3],
  "playerStartDir": 0,
  "layout": [ 
    ["#", "#", "#", "#", "#", "#", "#", "#", "#", "#", "#", "#", "#", "#", "#", "#", "#", "#", "#", "#"],
    ["#", " ", " ", "#", "c", " ", " ", " ", " ", " ", " ", " ", " ", " ", " ", " ", "|", " ", " ", "#"],
    ["#", " ", " ", ":", "c", " ", "#", " ", "#", "#", "#", "-", "#", " ", "#", "#", "#", "#", " ", "#"],
    ["#", " ", " ", "#", "t", " ", "#", "t", " ", " ", "|", " ", "#", " ", " ", "c", " ", "#", "c", "#"],
    ["#", "t", " ", ";", "t", "c", "#", "#", " ", "c", "#", " ", "#", "#", " ", " ", " ", "#", " ", "#"],
    ["#", "#", " ", "#", "#", " ", " ", " ", " ", " ", "#", " ", "c", "#", "c", " ", " ", " ", " ", "#"],
    ["#", " ", " ", " ", ":", " ", " ", " ", " ", " ", " ", " ", " ", " ", " ", " ", " ", " ", " ", "#"],
    ["#", "b", " ", "t", "#", " ", "b", " ", "#", "c", " ", " ", " ", " ", " ", "c", " ", " ", " ", "#"],
    ["#", "#", "-", "#", "#", " ", "#", "-", "#", " ", " ", " ", " ", " ", "#", "#", "#", "_", "#", "#"],
    ["#", " ", " ", "#", "c", " ", " ", " ", "#", " ", " ", " ", "c", " ", " ", " ", " ", " ", " ", "#"],
    ["#", " ", "b", "#", "#", " ", " ", "c", "#", " ", " ", " ", "#", "#", "#", "#", "#", "#", " ", "#"],
    ["#", " ", " ", " ", " ", " ", " ", " ", " ", "c", "#", " ", " ", " ", " ", " ", "|", " ", " ", "#"],
    ["#", "-", "#", "#", "#", "#", "#", " ", "#", "#", "#", "-", "#", "#", " ", " ", "#", "#", " ", "#"],
    ["#", " ", " ", " ", " ", " ", " ", " ", " ", " ", " ", " ", " ", " ", " ", " ", " ", " ", " ", "#"],
    ["#", "c", "#", " ", "#", "#", "c", " ", " ", "#", " ", " ", " ", "#", "#", "#", "#", "#", "#", "#"],
    ["#", " ", "#", " ", "|", " ", " ", " ", "b", " ", " ", " ", " ", "|", " ", " ", " ", " ", " ", "#"],
    ["#", " ", "#", "#", "#", "#", "#", "#", "#", "#", "#", " ", " ", "#", "#", " ", "#", "#", " ", "#"],
    ["#", " ", " ", " ", " ", " ", " ", " ", " ", "|", " ", " ", "c", " ", " ", " ", "|", " ", " ", "#"],
    ["#", "c", "c", "c", " ", "#", "#", " ", "#", "#", " ", "c", "c", "#", "#", "#", "#", " ", "#", "#"],
    ["#", "#", "#", "#", "#", "#", "#", "#", "#", "#", "#", "#", "#", "#", "#", "#", "#", "#", "#", "#"]
  ]
}
