{
  "name": "Large Test Map",
  "width": 100,
  "height": 100,
  "tileset": "tech",
  "playerStartDir": 1,
  "layout": [
    "####################################################################################################",
    "#          c           t                 w                 c                 t                 w   #",
    "#    w            c              t                 c                 w                 t           #",
    "#    ########    ########    ########    ########    ########    ########    ########    ########  #",
    "#    #      #    #      #    #      #    #      #    #      #    #      #    #      #    #      #  #",
    "#    #   @  #    #  c   #    #      #    #  w   #    #      #    #   t  #    #      #    #  c   #  #",
    "#    #      |    #      |    #      |    #      |    #      |    #      |    #      |    #      #  #",
    "#    ########    ########    ########    ########    ########    ########    ########    ########  #",
    "#      t                 w                 c                 t                 w                 c #",
    "#  c            t                 w                 c                 t                 w          #",
    "#    ########    ########    ########    ########    ########    ########    ########    ########  #",
    "#    #      #    #      #    #      #    #      #    #      #    #      #    #      #    #      #  #",
    "#    #  w   #    #      #    #  c   #    #      #    #  t   #    #      #    #  w   #    #      #  #",
    "#    #      |    #      |    #      |    #      |    #      |    #      |    #      |    #      #  #",
    "#    ########    ########    ########    ########    ########    ########    ########    ########  #",
    "#          c                 t                 w                 c                 t               #",
    "#    w                 c                 t                 w                 c                 t   #",
    "#    ########    ########    ########    ########    ########    ########    ########    ########  #",
    "#    #      #    #      #    #      #    #      #    #      #    #      #    #      #    #      #  #",
    "#    #      #    #  t   #    #      #    #  w   #    #      #    #  c   #    #      #    #  t   #  #",
    "#    #      |    #      |    #      |    #      |    #      |    #      |    #      |    #      #  #",
    "#    ########    ########    ########    ########    ########    ########    ########    ########  #",
    "#      t                 w                 c                 t                 w                 c #",
    "#  c            t                 w                 c                 t                 w          #",
    "#    ########    ########    ########    ########    ########    ########    ########    ########  #",
    "#    #      #    #      #    #      #    #      #    #      #    #      #    #      #    #      #  #",
    "#    #  c   #    #      #    #  w   #    #      #    #  t   #    #      #    #  c   #    #      #  #",
    "#    #      |    #      |    #      |    #      |    #      |    #      |    #      |    #      #  #",
    "#    ########    ########    ########    ########    ########    ########    ########    ########  #",
    "#          w                 c                 t                 w                 c               #",
    "#    t                 w                 c                 t                 w                 c   #",
    "#    ########    ########    ########    ########    ########    ########    ########    ########  #",
    "#    #      #    #      #    #      #    #      #    #      #    #      #    #      #    #      #  #",
    "#    #  t   #    #      #    #  c   #    #      #    #  w   #    #      #    #  t   #    #      #  #",
    "#    #      |    #      |    #      |    #      |    #      |    #      |    #      |    #      #  #",
    "#    ########    ########    ########    ########    ########    ########    ########    ########  #",
    "#      c                 t          #      w                 c                 t                 w #",
    "#  w            c                 t |               w                 c                 t          #",
    "#         w                 c       #         t                 w                 c             ####",
    "#    ########    ########    ########    ########    ########    ########    ########    ########  #",
    "#    #      #    #      #    #      #    #      #    #      #    #      #    #      #    #      #  #",
    "#    #      #    #  t   #    #      #    #  w   #    #      #    #  c   #    #      #    #  t   #  #",
    "#    #      |    #      |    #      |    #      |    #      |    #      |    #      |    #      #  #",
    "#    ########    ########    ########    ########    ########    ########    ########    ########  #",
    "#      t                 w                 c                 t                 w                 c #",
    "#  c            t                 w                 c                 t                 w          #",
    "#    ########    ########    ########    ########    ########    ########    ########    ########  #",
    "#    #      #    #      #    #      #    #      #    #      #    #      #    #      #    #      #  #",
    "#    #  c   #    #      #    #  w   #    #      #    #  t   #    #      #    #  c   #    #      #  #",
    "#    #      |    #      |    #      |    #      |    #      |    #      |    #      |    #      #  #",
    "#    ########    ########    ########    ########    ########    ########    ########    ########  #",
    "#          w                 c                 t                 w                 c               #",
    "#    t                 w                 c                 t                 w                 c   #",
    "#    ########    ########    ########    ########    ########    ########    ########    ########  #",
    "#    #      #    #      #    #      #    #      #    #      #    #      #    #      #    #      #  #",
    "#    #  t   #    #      #    #  c   #    #      #    #  w   #    #      #    #  t   #    #      #  #",
    "#    #      |    #      |    #      |    #      |    #      |    #      |    #      |    #      #  #",
    "#    ########    ########    ########    ########    ########    ########    ########    ########  #",
    "#      c                 t                 w                 c                 t                 w #",
    "#  w            c                 t                 w                 c                 t          #",
    "#    ########    ########    ########    ########    ########    ########    ########    ########  #",
    "#    #      #    #      #    #      #    #      #    #      #    #      #    #      #    #      #  #",
    "#    #  c   #    #      #    #  w   #    #      #    #  t   #    #      #    #  c   #    #      #  #",
    "#    #      |    #      |    #      |    #      |    #      |    #      |    #      |    #      #  #",
    "#    ########    ########    ########    ########    ########    ########    ########    ########  #",
    "#          w                 c                 t                 w                 c               #",
    "#    t                 w                 c                 t                 w                 c   #",
    "#    ########    ########    ########    ########    ########    ########    ########    ########  #",
    "#    #      #    #      #    #      #    #      #    #      #    #      #    #      #    #      #  #",
    "#    #  t   #    #      #    #  c   #    #      #    #  w   #    #      #    #  t   #    #      #  #",
    "#    #      |    #      |    #      |    #      |    #      |    #      |    #      |    #      #  #",
    "#    ########    ########    ########    ########    ########    ########    ########    ########  #",
    "#      c                 t                 w                 c                 t                 w #",
    "#    ########    ########    ########    ########    ########    ########    ########    ########  #",
    "#    #      #    #      #    #      #    #      #    #      #    #      #    #      #    #      #  #",
    "#    #  c   #    #      #    #  w   #    #      #    #  t   #    #      #    #  c   #    #      #  #",
    "#    #      |    #      |    #      |    #      |    #      |    #      |    #      |    #      #  #",
    "#    ########    ########    ########    ########    ########    ########    ########    ########  #",
    "#          w                 c                 t                 w                 c               #",
    "#    t                 w                 c                 t                 w                 c   #",
    "#    ########    ########    ########    ########    ########    ########    ########    ########  #",
    "#    #      #    #      #    #      #    #      #    #      #    #      #    #      #    #      #  #",
    "#    #  t   #    #      #    #  c   #    #      #    #  w   #    #      #    #  t   #    #      #  #",
    "#    #      |    #      |    #      |    #      |    #      |    #      |    #      |    #      #  #",
    "#    ########    ########    ########    ########    ########    ########    ########    ########  #",
    "#      c                 t                 w                 c                 t                 w #",
    "#  w            c                 t                 w                 c                 t          #",
    "####################################################################################################"
  ]
}