{
  "name": "Lab Sector A",
  "width": 30,
  "height": 30,
  "tileset": "tech",
  "playerStartDir": 1,
  "layout": [ 
    "##############################",
    "#                            #",
    "#c    #    #  @ #    #c  b   #",
    "#c                   ##'####-#",
    "#                 c  '       #",
    "#     ##'##:##       #      b#",
    "#     #      |       :   cc###",
    "#    b#  t   #c     c#   cc###",
    "#     #      #####-#####'#####",
    "#c    #####-##c    #t t#    c#",
    "#     '     t#  #  ##-##  #  #",
    "#######      :               #",
    "########-#######-######## # ##",
    "#  t       bb#      ###     ##",
    "#          bb#      ###     ##",
    "#c   c###'####              c#",
    "##    ###  | |     b##b     c#",
    "#     ###  ###     ####    ###",
    "#   c #t    t'     ####    ###",
    "#     't    t#     b##b      #",
    "##   c###tt###c             c#",
    "#     ########      #c       #",
    "#b        'c        #        #",
    "#    c    #   #t       ###-###",
    "#b   #        c        #     #",
    "#       #         #    '     #",
    "#            c#     ####  #  #",
    "#:##'##:###         #       ##",
    "#         |     #tct#cbtbc####",
    "##############################"
  ]
}
