{
  "name": "Test Map",
  "width": 20,
  "height": 20,
  "tileset": "tech",
  "playerStartDir": 0,
  "layout": [ 
    ["#", "#", "#", "#", "#", "#", "#", "#", "#", "#", "#", "#", "#", "#", "#", "#", "#", "#", "#", "#"],
    ["#", " ", "@", "|", " ", "c", " ", " ", " ", " ", " ", " ", " ", " ", " ", " ", "|", " ", " ", "#"],
    ["#", "w", " ", "#", " ", "w", "#", " ", "#", "#", "#", "-", "#", " ", "#", "#", "#", "#", " ", "#"],
    ["#", " ", " ", ":", "t", " ", "#", "t", " ", " ", "|", " ", ":", "t", " ", "c", " ", "#", "c", "#"],
    ["#", "t", " ", "#", "b", " ", "#", "#", " ", "c", "#", " ", "#", "#", " ", " ", " ", "#", " ", "#"],
    ["#", "#", "-", "#", " ", " ", "t", " ", "h", " ", "#", " ", "c", "#", "c", " ", " ", " ", "w", "#"],
    ["#", "#", " ", "#", "t", "w", " ", " ", " ", " ", " ", " ", " ", " ", " ", " ", "h", " ", " ", "#"],
    ["#", "b", " ", "w", " ", " ", "b", " ", "#", "c", " ", "h", " ", " ", "w", "c", " ", " ", "b", "#"],
    ["#", "#", ":", "#", "#", " ", "#", "-", "#", " ", " ", " ", " ", " ", "#", "#", "#", "_", "#", "#"],
    ["#", " ", " ", "#", "c", " ", " ", " ", "#", "b", " ", " ", "c", " ", " ", " ", " ", " ", " ", "#"],
    ["#", "b", " ", "#", "#", " ", "w", "c", "#", " ", "w", " ", "#", ":", "#", "#", "#", "#", " ", "#"],
    ["#", " ", " ", " ", " ", " ", " ", " ", " ", "c", "#", " ", " ", " ", " ", " ", "|", " ", "t", "#"],
    ["#", "-", "#", "#", "#", "#", "#", " ", "#", ":", "#", "-", "#", "#", " ", " ", "#", "#", " ", "#"],
    ["#", " ", " ", " ", " ", " ", " ", " ", " ", " ", " ", " ", " ", " ", " ", " ", " ", " ", " ", "#"],
    ["#", "c", "#", " ", "#", "#", "c", " ", " ", "#", " ", " ", "h", "#", "#", "#", "#", "#", "#", "#"],
    ["#", " ", "#", " ", "|", " ", " ", " ", "b", " ", "t", " ", " ", "|", " ", " ", " ", " ", " ", "#"],
    ["#", " ", "#", "#", "#", "#", "#", ":", "#", "#", "#", " ", " ", "#", "#", " ", "#", "#", " ", "#"],
    ["#", " ", " ", " ", " ", " ", " ", " ", " ", "|", " ", " ", "c", " ", " ", " ", "|", " ", " ", "#"],
    ["#", "c", "t", "c", " ", "#", "#", " ", "#", "#", " ", "c", "c", "#", "#", "#", "#", " ", "#", "#"],
    ["#", "#", "#", "#", "#", "#", "#", "#", "#", "#", "#", "#", "#", "#", "#", "#", "#", "#", "#", "#"]
  ]
}
