{
  "name": "Test Map",
  "width": 20,
  "height": 20,
  "tileset": "tech",
  "playerStartDir": 1,
  "layout": [ 
    ["#", "#", "#", "#", "#", "#", "#", "#", "#", "#", "#", "#", "#", "#", "#", "#", "#", "#", "#", "#"],
    ["#", " ", " ", "|", " ", "c", " ", " ", " ", " ", " ", " ", " ", " ", " ", " ", "|", " ", " ", "#"],
    ["#", " ", " ", "#", " ", " ", "#", " ", "#", "#", "#", "-", "#", " ", "#", "#", "#", "#", " ", "#"],
    ["#", " ", " ", ":", "t", "@", "#", "t", " ", " ", "|", " ", ":", "t", " ", "c", " ", "#", "c", "#"],
    ["#", "t", " ", "#", "b", " ", "#", "#", " ", "c", "#", " ", "#", "#", " ", " ", " ", "#", " ", "#"],
    ["#", "#", "-", "#", " ", " ", "t", " ", " ", " ", "#", " ", "c", "#", "c", " ", " ", " ", " ", "#"],
    ["#", "#", " ", "#", "t", ">", " ", " ", " ", " ", " ", " ", " ", " ", " ", " ", " ", " ", " ", "#"],
    ["#", "b", " ", " ", " ", " ", "b", " ", "#", "c", " ", " ", " ", " ", " ", "c", " ", " ", "b", "#"],
    ["#", "#", ":", "#", "#", " ", "#", "-", "#", " ", " ", " ", " ", " ", "#", "#", "#", "_", "#", "#"],
    ["#", " ", " ", "#", "c", " ", " ", " ", "#", "b", " ", " ", "c", " ", " ", " ", " ", " ", " ", "#"],
    ["#", "b", " ", "#", "#", " ", " ", "c", "#", " ", " ", " ", "#", ":", "#", "#", "#", "#", " ", "#"],
    ["#", " ", " ", " ", " ", " ", " ", " ", " ", "c", "#", " ", " ", " ", " ", " ", "|", " ", "t", "#"],
    ["#", "-", "#", "#", "#", "#", "#", " ", "#", ":", "#", "-", "#", "#", " ", " ", "#", "#", " ", "#"],
    ["#", " ", " ", " ", " ", " ", " ", " ", " ", " ", " ", " ", " ", " ", " ", " ", " ", " ", " ", "#"],
    ["#", "c", "#", " ", "#", "#", "c", " ", " ", "#", " ", " ", " ", "#", "#", "#", "#", "#", "#", "#"],
    ["#", " ", "#", " ", "|", " ", " ", " ", "b", " ", "t", " ", " ", "|", " ", " ", " ", " ", " ", "#"],
    ["#", " ", "#", "#", "#", "#", "#", ":", "#", "#", "#", " ", " ", "#", "#", " ", "#", "#", " ", "#"],
    ["#", " ", " ", " ", " ", " ", " ", " ", " ", "|", " ", " ", "c", " ", " ", " ", "|", " ", " ", "#"],
    ["#", "c", "t", "c", " ", "#", "#", " ", "#", "#", " ", "c", "c", "#", "#", "#", "#", " ", "#", "#"],
    ["#", "#", "#", "#", "#", "#", "#", "#", "#", "#", "#", "#", "#", "#", "#", "#", "#", "#", "#", "#"]
  ]
}
